%%%%%%%%%%%%%%%%%%%%%%%
%%%%%%%%%%%%%%%%%%%%%%%
%%%%%%%%%%%%%%%%%%%%%%%
%%%%%%%        %%%%%%%%
%%%%%%%        %%%%%%%%
%%%%%%%    ....%%%%%%%%
%%%%%%%   .....%%%%%%%%
%%%%%%%  ......%%%%%%%%
%%%%%%%  ......%%%%%%%%
%%%%%%%  ......%%%%%%%%
%%%%%%%   .....%%%%%%%%
%%%%%%%    ....%%%%%%%%
%%%%%%%        %%%%%%%%
%%%%%%%        %%%%%%%%
%%%%%%%        %%%%%%%%
%%%%%%%%%%%%%%%%%%%%%%%
%%%%%%%%%%%%%%%%%%%%%%%
%%%%%%%%%%%%%%%%%%%%%%%
#
%%%%%%%%%%%%%%%%%%%%%%%
%%%%%%%%%%%%%%%%%%%%%%%
%%%%%%%%%%%%%%%%%%%%%%%
%%%%%%%%%%%%%%%%%%%%%%%
%%%%          ...%%%%%%
%%%%         ....%%%%%%
%%%%  P     .....%%%%%%
%%%%        .....%%%%%%
%%%%        .....%%%%%%
%%%%        .....%%%%%%
%%%%        .....%%%%%%
%%%%         ....%%%%%%
%%%%          ...%%%%%%
%%%%%%%%%%%%%%%%%%%%%%%
%%%%%%%%%%%%%%%%%%%%%%%
%%%%%%%%%%%%%%%%%%%%%%%
%%%%%%%%%%%%%%%%%%%%%%%
%%%%%%%%%%%%%%%%%%%%%%%
#
%%%%%%%%%%%%%%%%%%%%%%%
%%%%%%%%%%%%%%%%%%%%%%%
%%%%%%%%%%%%%%%%%%%%%%%
%%%%%%%%%%%%%%%%%%%%%%%
%%%%%%%%%%%%%%%%%%%%%%%
%%%%%%%%%%%%%%%%%%%%%%%
%%%%%%%%%%%%%%%%%%%%%%%
%%%          ......%%%%
%%%          ......%%%%
%%%          ......%%%%
%%%          ......%%%%
%%%%%%%%%%%%%%%%%%%%%%%
%%%%%%%%%%%%%%%%%%%%%%%
%%%%%%%%%%%%%%%%%%%%%%%
%%%%%%%%%%%%%%%%%%%%%%%
%%%%%%%%%%%%%%%%%%%%%%%
%%%%%%%%%%%%%%%%%%%%%%%
%%%%%%%%%%%%%%%%%%%%%%%
#
