%%%%%%%%%%%%%%%%%%%%%%%%%%%%%%%%
%%%%%%%%%%%%%%%%%%%%%%%%%%%%%%%%
%%%%%%%%%%%%%%%%%%%%%%%%%   %%%%
%%%%%%    %%%%%%%%%%%%%%%%  %%%%
%%%%%%               %%%%%  %%%%
%%%%%%    %%%%%%%%%% %%%%%% %%%%
%%%%%%%%%%%%%%%%%%%%%%%%%%% %%%%
%%%%%%%%%%%%%% %%%%%% %%%%%%%%%%
%%%%%%%%%%%%%   %%%%%%%%%%%%%%%%
%%%%             %%%%% %%%%%%%%%
%%%%%%%%%%%%%%%%%%%%%%%%%%%%%%%%
%%%%%%%%%%%%%%%%%%%%%%%%%%%%%%%%
%%%%%%%%%%%%%%%%%%%%%%%%%%%%%%%%
%%%%%%%%%%%%%%%%%%%%%%%%%%%%%%%%
%%%%    %%%%%%%%%%%%%%%%%%%%%%%%
%%%%   %%%%%%%%%%%%%%%%%%%%%%%%%
%%%%  %%%%%%%%%%%%%%%%%%%%% %%%%
%%%% %%%%%%%%%       %%%%%% %%%%
%%%%%%%%%%%%%%       %%%%%% %%%%
%%%%%%%%%%%%%%%%%%%%%%%%%%% %%%%
%%%%%%%%%%%%%%%%%%%%%%%%%%% %%%%
%%%%%%%%%%%%%%%%%%%%%%%%%%%%%%%%
%%%%             %%%%%%%%%%%%%%%
%%%%             %%%%%%%%%%%%%%%
%%%%             %%%%%%%...%%%%%
%%%%             %%%%%%%...%%%%%
%%%%             %%%%%%%...%%%%%
%%%%             %%%%%%%%%%%%%%%
%%%%             %%%%%%%%%%%%%%%
%%%%%%%%%%%%%%%%%%%%%%%%%%%%%%%%
%%%%%%%%%%%%%%%%%%%%%%%%%%%%%%%%
#
%%%%%%%%%%%%%%%%%%%%%%%%%%%%%%%%
%%%%%%%%%%%%%%%%%%%%%%%%%%%%%%%%
%%%%%%%%%%%%%%%%%%%%%%%%%     %%
%%%%      %%%%%%%%%%%%%%%     %%
%%%%P       %%%%%%   %%%%%    %%
%%%%      %%%%%%%%%   %%%%    %%
%%%%%%%%%%%%%%%%%%%%  %%%%    %%
%%%%%%%%%%%%%%%%%%%%%  %%%%   %%
%%%%%%%%%%%%     %%%%  %%%%   %%
%%               %%%%% %%%%%  %%
%%   %%%%%%%%%%%%%%%%%  %%%%  %%
%%   %%%%%%%%%%%%%%%%   %%%   %%
%%   %%%%%%%%%%%%%%%%    %%%  %%
%%   %%%%%%%%%%%%%%%%%  %%%   %%
%%       %%%%%%%%%%%%% %%%%%  %%
%%      %%%%%%%%%%%%%  %%%%   %%
%%     %%%%%%%%%%%%%%   %%%   %%
%%    %%%%%%          %%%%    %%
%%   %%%%%%%          %%%%    %%
%%  %%%%%%%%%%%%%%%%% %%%%    %%
%%   %%%%%%%%%%%%%%%% %%%%    %%
%%   %%%%%%%%%%%%%%%%%%%%%%%%%%%
%%                 %%%  %%%%%%%%
%%                 %%%  %%%%%%%%
%%                 %%%  ...  %%%
%%                 %%%  ...  %%%
%%                 %%%  ...  %%%
%%                 %%%%%%%%%%%%%
%%                  %%%%%%%%%%%%
%%%%%%%%%%%%%%%%%%%%%%%%%%%%%%%%
%%%%%%%%%%%%%%%%%%%%%%%%%%%%%%%%
#
%%%%%%%%%%%%%%%%%%%%%%%%%%%%%%%%
%%%%%%%%%%%%%%%%%%%%%%%%%%%%%%%%
%%%%%%%%%%%%%%%%%%%%%%%%%%%%%%%%
%%%%%%%%%%%%%%%%%%%%%%%%%%%%%%%%
%%%%%%%%%%%%%%%%%%%%%%%%%     %%
%%%%%%%%%%%%%%%%%%%%%%%%%%    %%
%%%%%%%%%%%%%%%%%%%%   %%%    %%
%%%%%%%%%%%%%%%%%%%%   %%%    %%
%%%%%%%%%%%%%%%%%%%%%  %%%%   %%
%%%%%%%%%%%%%%%%%%%%%   %%%%  %%
%%%%%%%%%%%%%%%%%%%%%%  %%%%  %%
%%  %%%%%%%%%%%%%%%%%%   %%%  %%
%%  %%%%%%%%%%%%%%%%%%   %%%  %%
%%  %%%%%%%%%%%%%%%%%%  %%%%  %%
%%  %%%%%%%%%%%%%%%%%% %%%%%  %%
%%   %%%%%%%%%%%%%%%%% %%%%%  %%
%%    %%%%%%%%%%%%%%%% %%%%   %%
%%   %%%%%%%%%%%%%%%%% %%%    %%
%%   %%%%%%%%%%%%%%%%% %%     %%
%%   %%%%%%%%%%%%%%%%% %%%%%%%%%
%%   %%%%%%%%%%%%%%%%% %%%%%%%%%
%%   %%%%%%%%%%%%%%%%% %%%%%%%%%
%%   %%%%%%%%%%%%%%%%% %%%%%%%%%
%%   %%%%%%%%%%%%%%%%% %%%%%%%%%
%%                 %%% %%%%%%%%%
%%                 %%%%%%%%%%%%%
%%                 %%%%%%%%%%%%%
%%%%%%%%%%%%%%%%%%%%%%%%%%%%%%%%
%%%%%%%%%%%%%%%%%%%%%%%%%%%%%%%%
%%%%%%%%%%%%%%%%%%%%%%%%%%%%%%%%
%%%%%%%%%%%%%%%%%%%%%%%%%%%%%%%%
#
