%%%%%%%%%%%%%%%%%%%%%%%
%%%%%%%%%%%%%%%%%%%%%%%
%%%%  %%%%%%%%%%%%%%%%%
%%%%  %%%%%%%%%%  %%%%%
%%%%  %%%%%%%..   %%%%%
%%%%  %%%%%%%%%%  %%%%%
%%%%  %%%%%%%%%%%%%%%%%
%%%%        %%%%%%%%%%%
%%%%%%%%%%%%%%%%%%%%%%%
%%%%%%%%%%%%%%%%%%%%%%%
%%%%%%%%%%%%%%%%%%%%%%%
%%%%        %%%%% %%%%%
%%%%              %%%%%
%%%%        %%%%%%%%%%%
%%%%%%%%%%%%%%%%%%%%%%%
%%%%%%%%%%%%%%%%%%%%%%%
%%%%%%%%%%%%%      %%%%
%%%%               %%%%
%%%%               %%%%
%%%%%%%%%%%%%%%%%%%%%%%
%%%%%%%%%%%%%%%%%%%%%%%
#
%%%%%%%%%%%%%%%%%%%%%%%
%%%%%%%%%%%%%%%%%%%%%%%
%%       %%%%%%%%%%%%%%
%%      %%%%%%%%    %%%
%%      %%%%%%      %%%
%%      %%%%%%%%    %%%
%%       %%%%%%%%%  %%%
%%       %%%%%%%%%  %%%
%%%%%%%%%%%%% %%%%% %%%
%%%%%%%%%%%%%%%%%%% %%%
%%%%%%%%%%%%%%%%%%  %%%
%%        %%%% %%   %%%
%% P         %      %%%
%%        %%%%%%%%%%%%%
%%%%%%%%%%%%%%%%%%%%%%%
%%%%%%%%%%%%%%%%%%%%%%%
%%%%%%%%%%%%%%%      %%
%%                   %%
%%                   %%
%%%%%%%%%%%%%%%%%%%%%%%
%%%%%%%%%%%%%%%%%%%%%%%
#
%%%%%%%%%%%%%%%%%%%%%%%
%%%%%%%%%%%%%%%%%%%%%%%
%%%%%%%%%%%%%%%%%%%%%%%
%%%%%%%%%%%%%%%%%%%%%%%
%%      %%%%%%%%%%%%%%%
%%      %%%%%%%%%%% %%%
%%%%%%%%%%%%%%%%%%  %%%
%%%%%%%%%%%%%%%%%%  %%%
%%%%%%%%%%%%%%%%%%  %%%
%%%%%%%%%%%%%%%%%%% %%%
%%%%%%%%%%%%%%%%%%% %%%
%%%%%%%%%%%%%%%%%%%%%%%
%%%%%%%%%%%%%%%%%%%%%%%
%%%%%%%%%%%%%%%%%%%%%%%
%%%%%%%%%%%%%%%%%%%%%%%
%%%%%%%%%%%%%%%%%%%%%%%
%%%%%%%%%%%%%%%%%%%%%%%
%%%%%%%%%%%%%%%%%%%%%%%
%%%%%%%%%%%%%%%%%%%%%%%
%%%%%%%%%%%%%%%%%%%%%%%
%%%%%%%%%%%%%%%%%%%%%%%
#
