%%%%%%%%%%%%%%%%%%%%%%%%%%%%%%%%%%%%%%%%%%%%%%%%%%%%%%%%%%%%%%%%%%%%%%%%%
%%%%%%%%%%%%%%%%%%%%%%%%%%%%%%%%%%%%%%%%%%%%%%%%%%%%%%%%%%%%%%%%%%%%%%%%%
%%%%%%%%%%%%%%%%%%%%%%%%%%%                                        %%%%%%
%%%%%%%%%%%%%%%%%%%%%%%%%%%%                                       %%%%%%
%%%%%%%%%%      %%%%%%%%%%%%%                                      %%%%%%
%%%%%%%%%%       %%%%%%%%%%%%%%%%%%%%%%%%%%%%%%%%%                 %%%%%%
%%%%%%%%%%        %%%%%%%%%%%%%%%%%%%%%%%%%%%%%%%%                 %%%%%%
%%%%%%%%%%         %%%%%%%%%%%%%%%%%%%%%%%%%%%%%%%%                %%%%%%
%%%%%%%%%%                              %%%%%%%%%%%                %%%%%%
%%%%%%%%%%                              %%%%%%%%%%%%               %%%%%%
%%%%%%%%%%                               %%%%%%%%%%%               %%%%%%
%%%%%%%%%%                               %%%%%%%%%%%%              %%%%%%
%%%%%%%%%%         %%%%%%%%%%%%%%%%%%%%%  %%%%%%%%%%%              %%%%%%
%%%%%%%%%%        %%%%%%%%%%%%%%%%%%%%%%  %%%%%%%%%%%%             %%%%%%
%%%%%%%%%%       %%%%%%%%%%%%%%%%%%%%%%%   %%%%%%%%%%%             %%%%%%
%%%%%%%%%%%%%%%%%%%%%%%%%%%%  %%%%%%%%%%%  %%%%%%%%%%%%            %%%%%%
%%%%%%%%%%%%%%%%%%%%%%%%%%%   %%%%%%%%%%%   %%%%%%%%%%%            %%%%%%
%%%%%%%%%%%%%%%%%%%%%%%%%%     %%%%%%%%%%   %%%%%%%%%%%%           %%%%%%
%%%%%%                     %%%%%%%%%%%%%%    %%%%%%%%%%%           %%%%%%
%%%%%%                %%%%%%%%%%%%%%%%%%%%   %%%%%%%%%%%%          %%%%%%
%%%%%%            %%%%%%%%%%%%%%%%%%%%        %%%%%%%%%%%          %%%%%%
%%%%%%        %%%%%%%%%%%%%%%%%%%             %%%%%%%%%%%%%%%%%%%%%%%%%%%
%%%%%%   %%%%%%%%%%%%%%%%%%%%                  %%%%%%%%%%%%%%%%%%%%%%%%%%
%%%%%%%%%%%%%%%%%%%%%%%%%%%%%%%%%%%%%%%%%%%%%% %%%%%%%%%%%%%%%%%%%%%%%%%%
%%%%%%    %%%%%%%%%%%%%%%%%%%%%%%%%%%%%%%%%%%%            .......%%%%%%%%
%%%%%%%%%%%%%%%%%%%%%%%%%%%%%%%%%%%%%%%%%%%%%%%%%%%%%%%%%%%%%%%%%%%%%%%%%
%%%%%%                             %%%%%%%%%%%%%%%%%%%%%%%%%%%%%%%%%%%%%%
%%%%%%                             %%%%%%%%%%%%%%%%%%%%%%%%%%%%%%%%%%%%%%
%%%%%%                             %%%%%%%%%%%%%%%%%%%%            %%%%%%
%%%%%%         %%%%%%%%%%%%%%%%%%%%%%%%%%%%%%%%%%%%%%%%            %%%%%%
%%%%%%        %%%%%%%%%%%%%%%%%%%%%%%%%%%%%%%%%%%%%%%%%            %%%%%%
%%%%%%       %%%%%%%%%%%%%%%%%%%%%%%%%%%%%%%%%%%%%%%%%             %%%%%%
%%%%%%      %%%%%%%%%%%%%                  %%%%%%%%%%%             %%%%%%
%%%%%%     %%%%%%%%%%%%%                   %%%%%%%%%%%             %%%%%%
%%%%%%    %%%%%%%%%%%%%                    %%%%%%%%%%%             %%%%%%
%%%%%%   %%%%%%%%%%%%%                     %%%%%%%%%%%             %%%%%%
%%%%%%  %%%%%%%%%%%%%                      %%%%%%%%%%%             %%%%%%
%%%%%% %%%%%%%%%%%%%.                      %%%%%%%%%%%             %%%%%%
%%%%%%%%%%%%%%%%%%%..                      %%%%%%%%%%%             %%%%%%
%%%%%%%%%%%%%%%%%%%%%%%%%%%%%%%%%%%%%%%%%%%%%%%%%%%%%%             %%%%%%
%%%%%%%%%%%%%%%%%%%%%%%%%%%%%%%%%%%%%%%%%%%%%%%%%%%%%%             %%%%%%
%%%%%%%%%%%%%%%%%%%%%%%%%%%%%%%%%%%%%%%%%%%%%%%%%%%%%%             %%%%%%
%%%%%%                             %%%%%%%%%%%%%%%%%%%             %%%%%%
%%%%%%                             %%%%%%%%%%%%%%%%%%%%%%%%%%%%%%% %%%%%%
%%%%%%                             %%%%%%%%%%%%%%%%%%%%%%%%%%%%%%% %%%%%%
%%%%%%                             %%%%%%%%%%%%%%%%%%%%%%%%%%%%%%% %%%%%%
%%%%%%                             %%%%%%%%%%%         %%%%%%%%%%% %%%%%%
%%%%%%                             %%%%%%%%%%%         %%%%%%%%%%% %%%%%%
%%%%%%                             %%%%%%%%%%%.........%%%%%%%%%%% %%%%%%
%%%%%%                             %%%%%%%%%%%.........%%%%%%%%%%% %%%%%%
%%%%%%                             %%%%%%%%%%%.........%%%%%%%%%%% %%%%%%
%%%%%%                             %%%%%%%%%%%%%%%%%%%%%%%%%%%%%%% %%%%%%
%%%%%%                             %%%%%%%%%%%%%%%%%%%%%%%%%%%%%%% %%%%%%
%%%%%%%%%%%%%%%%%%%%%%%%%%%%%%%%%%%%%%%%%%%%%%%%%%%%%%%%%%%%%%%%%%%%%%%%%
%%%%%%%%%%%%%%%%%%%%%%%%%%%%%%%%%%%%%%%%%%%%%%%%%%%%%%%%%%%%%%%%%%%%%%%%%
#
%%%%%%%%%%%%%%%%%%%%%%%%%%%%%%%%%%%%%%%%%%%%%%%%%%%%%%%%%%%%%%%%%%%%%%%%%
%%%%%%%%%%%%%%%%%%%%%%%%%%%%%%%%%%%%%%%%%%%%%%%%%%%%%%%%%%%%%%%%%%%%%%%%%
%%%%%%%%%%%%%%%%%%%%%%%%%%%%%%%%%%%%%%%%%%%%%%%%%%%%%%%%%%%%%%%%%%%%%%%%%
%%%%%%%%%%%%%%%%%%%%%%%%%%%%%%%%%%%%%%%%%%%%%%%%%%%%%%%%%%%%%%%%%%%%%%%%%
%%%%%%%%%%%%%%%%%%%%%%%%%%%%%%%%%%%%%%%%%%%%%                        %%%%
%%%%%%%%%%%%%%%%%%%%%%%%%%%%%%%%%%%%%%%%%%%%% %%                     %%%%
%%%%%%%%            %%%%%%%%%%%%%%%%%%%%%%%%%%%%                     %%%%
%%%%%%%%             %%%%%%%%%%%%%%%%%%%%%%%%%%%%                    %%%%
%%%%%%%%P             % %%%%%%%%%%%%%%%%%%%%%%%%%                    %%%%
%%%%%%%%                %%%%%%%%%%%%%%%%%%%%%%%%%%                   %%%%
%%%%%%%%                %%%%%%%%%%%        %%%%%%%                   %%%%
%%%%%%%%              % %%%%%%%%%%%        %%%%%%%%                  %%%%
%%%%%%%%            %%%%%%%%%%%%%%%  %      %%%%%%%                  %%%%
%%%%%%%%%%%%%%%%%%%%%%%%%%%%%%%%%%%%%%      %%%%%%%%                 %%%%
%%%%%%%%%%%%%%%%%%%%%%%%%%%%%%%%%%%%%%       %%%%%%%                 %%%%
%%%%%%%%%%%%%%%%%%%%%%%%%%%%%%%%%%%%%%%      %%%%%%%%                %%%%
%%%%%%%%%%%%%%%%%%%%%%%%%%%%%%%%%%%%%%%       %%%%%%%                %%%%
%%%%%%%%%%%%%%%%%%%%%%%%%  %%%%%%%%%%%%       %%%%%%%%               %%%%
%%%%%%%%%%%%%%%%%%%%% %%%%%%%%%%%%%%%          %%%%%%%               %%%%
%%%%%%%%%%%%%%%%%%%%%%%%%%%%%%%%%%%%%          %%%%%%%%%%%%%%%%%%%%%%%%%%
%%%%          %%%%%%%%%%%%%%%%%%%%%%%           %%%%%%%%%%%%%%%%%%%%%%%%%
%%%%      %%%%%%%%%%%%%%%%%%%%%%%%%%%%%%%       %%%%%%%%%%%%%%%%%%%%%%%%%
%%%%      %%%%%%%%%%%%%%%%%%%%%%%%%%%%%%%        %%%%%%%%%%%%%%%%%%%%%%%%
%%%%      %%%%%%%%%%%%%%%%%%%%%%%%%%%%%%%        %%%%%%%%%%%%%%%%%%%%%%%%
%%%%      %%%%%%%%%%%%%%%%%%%%%%%%%%%%%%%         %%%%%%%%%%%%%%%%%%%%%%%
%%%%      %%%%%%%%%%%%%%%%%%%%%%%%%%%%%%%%%%   %  %%%%%%%%%%%%%%%%%%%%%%%
%%%%      %%%%%%%%%%%%%%%%%%%%%%%%%%%%%%%%%%   %%%%%%%%%%%%%%%%%%%%%%%%%%
%%%%      %%%%%%%%%%%%%%%%%%%%%%%%%%%%%%%%%%   %%%%%%%%%%%%%%%%%%%%%%%%%%
%%%%              % %%%%%%%%%%%%%%%%%%%%%%%%  %%%%%%%%%%%%%%%%%%%%%%%%%%%
%%%%             %%%%%%%%%%%%%%%%%%%%%%%%%%%  %%%%%%%%%%%%%%%%%%%%%%%%%%%
%%%%            %%%%%%%%%%%%%%%%%%%%%%%%%     %%%%%%%                %%%%
%%%%           %%%%%%%%%%%%%%%%%%%%%%%%%%    %%%%%%%                 %%%%
%%%%          %%%%%%%%%%%%%%%%%%%%%%%%%%%       %%%%                 %%%%
%%%%         %%%%%%%%%%%%%%%%%%%%%%%%%%%%    %%%%%%%                 %%%%
%%%%        %%%%%%%%%                        %%%%%%%                 %%%%
%%%%       %%%%%%%%%                         %%%%%%%                 %%%%
%%%%      %%%%%%%%%                          %%%%%%%                 %%%%
%%%%     %%%%%%%%%%%%%%%%%%%%%%%%%%%%%%%%    %%%%%%%                 %%%%
%%%%    %%%%%%%%%%%%%%%%%%%%%%%%%%%%%%%%%    %%%%%%%                 %%%%
%%%%     %%%%%%%%%%%%%%%%%%%%%%%%%%%%%%%%    %%%%%%%                 %%%%
%%%%      %%%%%%%%%%%%%%%%%%%%%%%%%%%%%%%    %%%%%%%                 %%%%
%%%%      %%%%%%%%%%%%%%%%%%%%%%%%%%%%%%%%%% %%%%%%%%%%%%%%%%        %%%%
%%%%      %%%%%%%%%%%%%%%%%%%%%%%%%%%%%%%%%% %%%%%%%%%%%%%%%%        %%%%
%%%%      %%%%%%%%%%%%%%%%%%%%%%%%%%%%%%%%%% %%%%%%%%%%%%%%%%        %%%%
%%%%                                 %%%%%%%    %%%%%%%%%%%%%        %%%%
%%%%                                 %%%%%%%    %%%%%%%%%%%%%%%%     %%%%
%%%%                                 %%%%%%%    %%%%%%%%%%%%%%%%     %%%%
%%%%                                 %%%%%%%    %%%%%%%%%%%%%%%%     %%%%
%%%%                                 %%%%%%%    .....    %%%%%%%     %%%%
%%%%                                 %%%%%%%%%%%%%%%%%%%%%%%%%%%     %%%%
%%%%                                 %%%%%%%%%%%%%%%%%%%%%%%%%%%     %%%%
%%%%%%%%%%%%%%%%%%%%%%%%%%%%%%%%%%%%%%%%%%%%%%%%%%%%%%%%%%%%%%%%%%%%%%%%%
%%%%%%%%%%%%%%%%%%%%%%%%%%%%%%%%%%%%%%%%%%%%%%%%%%%%%%%%%%%%%%%%%%%%%%%%%
%%%%%%%%%%%%%%%%%%%%%%%%%%%%%%%%%%%%%%%%%%%%%%%%%%%%%%%%%%%%%%%%%%%%%%%%%
%%%%%%%%%%%%%%%%%%%%%%%%%%%%%%%%%%%%%%%%%%%%%%%%%%%%%%%%%%%%%%%%%%%%%%%%%
#
%%%%%%%%%%%%%%%%%%%%%%%%%%%%%%%%%%%%%%%%%%%%%%%%%%%%%%%%%%%%%%%%%%%%%%%%%
%%%%%%%%%%%%%%%%%%%%%%%%%%%%%%%%%%%%%%%%%%%%%%%%%%%%%%%%%%%%%%%%%%%%%%%%%
%%%%%%%%%%%%%%%%%%%%%%%%%%%%%%%%%%%%%%%%%%%%%%%%%%%%%%%%%%%%%%%%%%%%%%%%%
%%%%%%%%%%%%%%%%%%%%%%%%%%%%%%%%%%%%%%%%%%%%%%%%%%%%%%%%%%%%%%%%%%%%%%%%%
%%%%%%%%%%%%%%%%%%%%%%%%%%%%%%%%%%%%%%%%%%%%%%%%%%%%%%%%%%%%%%%%%%%%%%%%%
%%%%%%%%%%%%%%%%%%%%%%%%%%%%%%%%%%%%%%%%%%%%%%%%%%%%%%%%%%%%%%%%%%%%%%%%%
%% %%%%%%%%%%%%%%%%%%%%%%%%%%%%%%%%%%%%%%%%%%%%%                       %%
%% %%%%%%%%%%%%%%%%%%%%%%%%%%%%%%%%%%%%%%%%%%%%%%                      %%
%% %%%              %%%%%%%%%%%%%%%%%%%%%%%%%%%%%                      %%
%% %%%               %%%%%%%%%%%%%%%%%%%%%%%%%%%%%                     %%
%% %%%               %%%%%%%%%%%%%%%%%%%%%%%%%%%%%                     %%
%% %%%%%%%%%%%%%%%%%%%%%%%%%%%%%%%%%%%%%%%%%%%%%%%%                    %%
%% %%%%%%%%%%%%%%%%%%%%%%%%%%%%%%%%%%       %%%%%%%                    %%
%% %%%%%%%%%%%%%%%%%%%%%%%%%%%%%%%%%%%      %%%%%%%%                   %%
%% %%%%%%%%%%%%%%%%%%%%%%%%%%%%%%%%%%        %%%%%%%                   %%
%% %%%%%%%%%%%%%%%%%%%%%%%%%%%%%%%%%%        %%%%%%%%                  %%
%% %%%%%%%%%%%%%%%%%%%%%%%%%%%%%%%%%%         %%%%%%%                  %%
%% %%%%%%%%%%%%%%%%%%%%%%%%%%%%%%%%%%         %%%%%%%%%%%%%%%%%%%%%%%%%%%
%% %%%%%%%%%%%%%%%%%%%%%%%%%%%%%%%%%%          %%%%%%%%%%%%%%%%%%%%%%%%%%
%% %%%%%%%%%%%%%%%%%%%%%%%%%%%%%%%%%%%%%%%     %%%%%%%%%%%%%%%%%%%%%%%%%%
%% %%%%%%%%%%%%%%%%%%%%%%%%%%%%%%%%%%%%%%%      %%%%%%%%%%%%%%%%%%%%%%%%%
%% %%%%%%%%%%%%%%%%%%%%%%%%%%%%%%%%%%%%%%%      %%%%%%%%%%%%%%%%%%%%%%%%%
%%        %%%%%%%%%%%%%%%%%%%%%%%%%%%%%%%%       %%%%%%%%%%%%%%%%%%%%%%%%
%%        %%%%%%%%%%%%%%%%%%%%%%%%%%%%%%%%       %%%%%%%%%%%%%%%%%%%%%%%%
%%        %%%%%%%%%%%%%%%%%%%%%%%%%%%%%%%%      %%%%%%%%%%%%%%%%%%%%%%%%%
%%        %%%%%%%%%%%%%%%%%%%%%%%%%%%%%%%%      %%%%%%%%%%%%%%%%%%%%%%%%%
%%        %%%%%%%%%%%%%%%%%%%%%%%%%%%%%%%%      %%%%%%%%%%%%%%%%%%%%%%%%%
%%        %%%%%%%%%%%%%%%%%%%%%%%%%%%%%%%%     %%%%%%%%%%%%%%%%%%%%%%%%%%
%%        %%%%%%%%%%%%%%%%%%%%%%%%%%%%%%%%     %%%%%%%%%%%%%%%%%%%%%%%%%%
%%       %%%%%%%%%%%%%%%%%%%%%%%%%%%%%%%%%     %%%%%%%%%%%%%%%%%%%%%%%%%%
%%            %%%%%%%%%%%%%%%%%%%%%%%%%%%%     %%%%%%%%%%%%%%%%%%%%%%%%%%
%%           %%%%%%%%%%%%%%%%%%%%%%%%%%%%%     %%%%%%%%%%%%%%%%%%%%%%%%%%
%%          %%%%%%%%%%%%%%%%%%%%%%%%%%%%%%     %%%%                    %%
%%         %%%%%%%%%%%%%%%%%%%%%%%%%%%%%%%     %%%%                    %%
%%        %%%%%%%%%%%%%%%%%%%%%%%%%%%%%%%%     %%%%                    %%
%%       %%%%%%%%%%%%%%%%%%%%%%%%%%%%%%%%%     %%%                     %%
%%        %%%%%%%%%%%%%%%%%%%%%%%%%%%%%%%%     %%%                     %%
%%        %%%%%%%%%%%%%%%%%%%%%%%%%%%%%%%%     %%%                     %%
%%        %%%%%%%%%%%%%%%%%%%%%%%%%%%%%%%%     %%%                     %%
%%        %%%%%%%%%%%%%%%%%%%%%%%%%%%%%%%%     %%%%%%%%%%%%%%%         %%
%%        %%%%%%%%%%%%%%%%%%%%%%%%%%%%%%%%     %%%%%%%%%%%%%%%         %%
%%        %%%%%%%%%%%%%%%%%%%%%%%%%%%%%%%%     %%%%%%%%%%%%%%%         %%
%%        %%%%%%%%%%%%%%%%%%%%%%%%%%%%%%%%     %%%%%%%%%%%%%%%         %%
%%        %%%%%%%%%%%%%%%%%%%%%%%%%%%%%%%%     %%%%%%%%%%%%%%%         %%
%%        %%%%%%%%%%%%%%%%%%%%%%%%%%%%%%%%     %%%%%%%%%%%%%%%         %%
%%       %%%%%%%%%%%%%%%%%%%%%%%%%%%%%%%%%     %%%%%%%%%%%%%%%         %%
%%                                     %%%     %%%%%%%%%%%%%%%         %%
%%                                     %%%%%%%%%%%%%%%%%%%%%%%         %%
%%                                     %%%%%%%%%%%%%%%%%%%%%%%         %%
%%%%%%%%%%%%%%%%%%%%%%%%%%%%%%%%%%%%%%%%%%%%%%%%%%%%%%%%%%%%%%%%%%%%%%%%%
%%%%%%%%%%%%%%%%%%%%%%%%%%%%%%%%%%%%%%%%%%%%%%%%%%%%%%%%%%%%%%%%%%%%%%%%%
%%%%%%%%%%%%%%%%%%%%%%%%%%%%%%%%%%%%%%%%%%%%%%%%%%%%%%%%%%%%%%%%%%%%%%%%%
%%%%%%%%%%%%%%%%%%%%%%%%%%%%%%%%%%%%%%%%%%%%%%%%%%%%%%%%%%%%%%%%%%%%%%%%%
%%%%%%%%%%%%%%%%%%%%%%%%%%%%%%%%%%%%%%%%%%%%%%%%%%%%%%%%%%%%%%%%%%%%%%%%%
%%%%%%%%%%%%%%%%%%%%%%%%%%%%%%%%%%%%%%%%%%%%%%%%%%%%%%%%%%%%%%%%%%%%%%%%%
#
