%%%%%%%%%%%%%%%%%%%%%%%%%%%%%%%%%%%%%%%%%%%%%
%%%%%%%%%%%%%%%%%%%%%%%%%%%%%%%%%%%%%%%%%%%%%
%%%%%%                 %%%%%%%%%%%%%%%%%%%%%%
%%%%%%                %%%%%%%%%%%%%%%%%%%%%%%
%%%%%%       %%%%%%%%%%%%%%%%%%%%    %%%%%%%%
%%%%%%       %%%%%%%%%%%%%%%%%%%     %%%%%%%%
%%%%%%       %%%%%%%%%%%%%%%%%%%     %%%%%%%%
%%%%%%       %%%%%%%%%%%......       %%%%%%%%
%%%%%%       %%%%%%%%%%%......       %%%%%%%%
%%%%%%       %%%%%%%%%%%......       %%%%%%%%
%%%%%%       %%%%%%%%%%%%%%%%%%%     %%%%%%%%
%%%%%%       %%%%%%%%%%%%%%%%%%%     %%%%%%%%
%%%%%%       %%%%%%%%%%%%%%%%%%%%    %%%%%%%%
%%%%%%                %%%%%%%%%%%%%%%%%%%%%%%
%%%%%%                 %%%%%%%%%%%%%%%%%%%%%%
%%%%%%                 %%%%%%%%%%%%%%%%%%%%%%
%%%%%%                     %%%%%%%%%%%%%%%%%%
%%%%%%%%%%%%%%%%%%%%%%%%%%%%%%%%%%%%%%%%%%%%%
%%%%%%%%%%%%%%%%%%%%%%%%%%%%%%%%%%%%%%%%%%%%%
%%%%%%%%%%%%%%%%%%%%%%%%%%%%%%%%%%%%%%%%%%%%%
%%%%%%            %%%%%%%%%%%%%%%%%% %%%%%%%%
%%%%%%              %%%%%%%%%%%%%%%  %%%%%%%%
%%%%%%                 %         %   %%%%%%%%
%%%%%%                               %%%%%%%%
%%%%%%                               %%%%%%%%
%%%%%%                               %%%%%%%%
%%%%%%                               %%%%%%%%
%%%%%%                 %%%%%%%%%%%%%%%%%%%%%%
%%%%%%             %%%%%%%%%%%%%%%%%%%%%%%%%%
%%%%%%%%%%%%%%%%%%%%%%%%%%%%%%%%%%%%%%%%%%%%%
%%%%%%%%%%%%%%%%%%%%%%%%%%%%%%         %%%%%%
%%%%%%%%%%%%%%%%%%%%%%%%%%             %%%%%%
%%%%%%                                 %%%%%%
%%%%%%                                 %%%%%%
%%%%%%                                 %%%%%%
%%%%%%                                 %%%%%%
%%%%%%                                 %%%%%%
%%%%%%                                 %%%%%%
%%%%%%                                 %%%%%%
%%%%%%%%%%%%%%%%%%%%%%%%%%%%%%%%%%%%%%%%%%%%%
%%%%%%%%%%%%%%%%%%%%%%%%%%%%%%%%%%%%%%%%%%%%%
#
%%%%%%%%%%%%%%%%%%%%%%%%%%%%%%%%%%%%%%%%%%%%%
%%%%%%%%%%%%%%%%%%%%%%%%%%%%%%%%%%%%%%%%%%%%%
%%%%%%%%%%%%%%%%%%%%%%%%%%%%%%%%%%%%%%%%%%%%%
%%%%%%%%%%%%%%%%%%%%%%%%%%%%%%%%%%%%%%%%%%%%%
%%%%              %%%%%%%%%%%%%%%%%%%%%%%%%%%
%%%%              %%%%%%%%%%%%%%%%%%%%%%%%%%%
%%%%           %%%%%%%%%%%% %%         %%%%%%
%%%%           %%%%%%%%%%%%            %%%%%%
%%%%           %%%%%%%%%%%%            %%%%%%
%%%%           %%%%%%%%%%%%            %%%%%%
%%%%           %%%%%%%%%%%% %%         %%%%%%
%%%%              %%%%%%%%%%%%%%%%%%   %%%%%%
%%%%              %%%%%%%%%%%%%%%%%%   %%%%%%
%%%%              %%%%%%%%%%%%%%%%%%   %%%%%%
%%%%              %%%%%%%%%%%%%%%%%%   %%%%%%
%%%%%%%%%%%%%%%%%%%%%    %% %%%%%%%%%  %%%%%%
%%%%%%%%%%%%%%%%%%%%%%%%    %%%%%%%%%% %%%%%%
%%%%%%%%%%%%%%%%%%%%%%%%%%% %%%%%%%%%  %%%%%%
%%%%%%%%%%%%%%%%%%%%%%%%%%%%%%%%%%%%   %%%%%%
%%%%%%%%%%%%%%%%%%%%%%%%%%%%%%%%%%%    %%%%%%
%%%%%%%%%%%%%%%%%%%%%%%%%%%%%%%%%%     %%%%%%
%%%%%%%%%%%%%%%%%%%%%%%%%%%%%%%%%      %%%%%%
%%%%                  %%%%%% %%%       %%%%%%
%%%%                     %%%  %        %%%%%%
%%%%  P                                %%%%%%
%%%%                       %%%%%%%%%%%%%%%%%%
%%%%                   %%%%%%%%%%%%%%%%%%%%%%
%%%%%%%%%%%%%%%%%%%%%%%%%%%%%%%%%%%%%%%%%%%%%
%%%%%%%%%%%%%%%%%%%%%%%%%%%%%%%%%%%%%%%%%%%%%
%%%%%%%%%%%%%%%%%%%%%%%%%%%%%%%%%%%%%%%%%%%%%
%%%%%%%%%%%%%%%%%%%%%%%%%%%%%%%%%%%%%%%%%%%%%
%%%%%%%%%%%%%%%%%%%%%%%%%%%%%%%%%%%%%%%%%%%%%
%%%%%%%%%%%%%%%%%%%%%%%%%%               %%%%
%%%%%%%%%%%%%%%%%%%%%%                   %%%%
%%%%                                     %%%%
%%%%                                     %%%%
%%%%                                     %%%%
%%%%%%%%%%%%%%%%%%%%%%%%%%%%%%%%%%%%%%%%%%%%%
%%%%%%%%%%%%%%%%%%%%%%%%%%%%%%%%%%%%%%%%%%%%%
%%%%%%%%%%%%%%%%%%%%%%%%%%%%%%%%%%%%%%%%%%%%%
%%%%%%%%%%%%%%%%%%%%%%%%%%%%%%%%%%%%%%%%%%%%%
#
%%%%%%%%%%%%%%%%%%%%%%%%%%%%%%%%%%%%%%%%%%%%%
%%%%%%%%%%%%%%%%%%%%%%%%%%%%%%%%%%%%%%%%%%%%%
%%%%%%%%%%%%%%%%%%%%%%%%%%%%%%%%%%%%%%%%%%%%%
%%%%%%%%%%%%%%%%%%%%%%%%%%%%%%%%%%%%%%%%%%%%%
%%%%%%%%%%%%%%%%%%%%%%%%%%%%%%%%%%%%%%%%%%%%%
%%%%%%%%%%%%%%%%%%%%%%%%%%%%%%%%%%%%%%%%%%%%%
%%               %%%%%%%%%%%%%%%%%%%%%%%%%%%%
%%                %%%%%%%%%%%%%%%%%%%%%%%%%%%
%%                %%%%%%%%%%%            %%%%
%%                %%%%%%%%%%%%%%%%%%%    %%%%
%%               %%%%%%%%%%%%%%%%%%%     %%%%
%%               %%%%%%%%%%%%%%%%%%%     %%%%
%%               %%%%%%%%%%%%%%%%%%%     %%%%
%%%%%%%%%%%%%%%%%%%%%%%%%%%%%%%%%%%%     %%%%
%%%%%%%%%%%%%%%%%%%%%%%%%%%%%%%%%%%%     %%%%
%%%%%%%%%%%%%%%%%%%%%%%%%%%%%%%%%%%%     %%%%
%%%%%%%%%%%%%%%%%%%%%%%%%%%%%%%%%%%%     %%%%
%%%%%%%%%%%%%%%%%%%%%%%%%%%%%%%%%%%%     %%%%
%%%%%%%%%%%%%%%%%%%%%%%%%%%%%%%%%%%%     %%%%
%%%%%%%%%%%%%%%%%%%%%%%%%%%%%%%%%%%%%    %%%%
%%%%%%%%%%%%%%%%%%%%%%%%%%%%%%%%%%%%     %%%%
%%%%%%%%%%%%%%%%%%%%%%%%%%%%%%%%%%%      %%%%
%%%%%%%%%%%%%%%%%%%%%%%%%%%%%%%%%%       %%%%
%%%%%%%%%%%%%%%%%%%%%%%%%%%%%%%%%%%%%%%%%%%%%
%%                    %%%%%%%%%%%%%%%%%%%%%%%
%%%%%%%%%%%%%%%%%%%%%%%%%%%%%%%%%%%%%%%%%%%%%
%%%%%%%%%%%%%%%%%%%%%%%%%%%%%%%%%%%%%%%%%%%%%
%%%%%%%%%%%%%%%%%%%%%%%%%%%%%%%%%%%%%%%%%%%%%
%%%%%%%%%%%%%%%%%%%%%%%%%%%%%%%%%%%%%%%%%%%%%
%%%%%%%%%%%%%%%%%%%%%%%%%%%%%%%%%%%%%%%%%%%%%
%%%%%%%%%%%%%%%%%%%%%%%%%%%%%%%%%%%%%%%%%%%%%
%%%%%%%%%%%%%%%%%%%%%%%%%%%%%%%%%%%%%%%%%%%%%
%%%%%%%%%%%%%%%%%%%%%%%%%%%%%%%%%%%%%%%%%%%%%
%%%%%%%%%%%%%%%%%%%%%%%%%%%%%%%%%%%%%%%%%%%%%
%%%%%%%%%%%%%%%%%%%%%%%%%%                 %%
%%%%%%%%%%%%%%%%%%%%%%%%%%%%%%%%%%%%%%%%%%%%%
%%%%%%%%%%%%%%%%%%%%%%%%%%%%%%%%%%%%%%%%%%%%%
%%%%%%%%%%%%%%%%%%%%%%%%%%%%%%%%%%%%%%%%%%%%%
%%%%%%%%%%%%%%%%%%%%%%%%%%%%%%%%%%%%%%%%%%%%%
%%%%%%%%%%%%%%%%%%%%%%%%%%%%%%%%%%%%%%%%%%%%%
%%%%%%%%%%%%%%%%%%%%%%%%%%%%%%%%%%%%%%%%%%%%%
#
