%%%%%%%%%%%%%%%%%%%%%%%%%%%%%%%%
%%%%%%%%%%%%%%               %%%
%%%%%    %%%%%%%%%%%%%%%%    %%%
%%%%%               %%%%%%   %%%
%%%%%                %%%%%   %%%
%%%%%     %%%%%%%%%% %%%%%%  %%%
%%%%%    %%%%%%%%%%%%%%%%%%  %%%
%%%%%%%%%%%%%% %%%%%% %%%%%% %%%
%%%             %%%%%%%%%%%% %%%
%%%              %%%%% %%%%% %%%
%%%              %%%%%%%%%%%%%%%
%%%%%%%%%%%%%%%%%%%%%%% %%%%%%%%
%%%%%%%%%%%%%%%%%%%%%%% %%%%%%%%
%%%               %%%%%%%%%%%%%%
%%%               %%%%%%%%%%%%%%
%%%    %%%%%%%%%%%%%%%%%%%%% %%%
%%%   %%%%%%%        %%%%%%  %%%
%%%  %%%%%%%%        %%%%%%  %%%
%%% %%%%%%%%%        %%%%%%  %%%
%%%%%%%%%%%%%        %%%%%%  %%%
%%%%%%%%%%%%%%%%%%%%%%%%%%%  %%%
%%%               %%%%%%%%%  %%%
%%%               %%%%%%%%%%%%%%
%%%               %%%%%     %%%%
%%%               %%%%%.....%%%%
%%%               %%%%%.....%%%%
%%%               %%%%%.....%%%%
%%%               %%%%%     %%%%
%%%               %%%%%%%%%%%%%%
%%%                          %%%
%%%%%%%%%%%%%%%%%%%%%%%%%%%%%%%%
#
%%%%%%%%%%%%%%%%%%%%%%%%%%%%%%%%
%%%%%%%%%%%%%%%%%%%%%%%%%%%%%%%%
%%%%%%%%%%%%%%%%%%%%%%%%%     %%
%%%%      %%%%%%%%%%%%%%%     %%
%%%%P       %%%%%%   %%%%%    %%
%%%%      %%%%%%%%%   %%%%    %%
%%%%%%%%%%%%%%%%%%%%  %%%%    %%
%%%%%%%%%%%%%%%%%%%%%  %%%%   %%
%%%%%%%%%%%%     %%%%  %%%%   %%
%%               %%%%% %%%%%  %%
%%   %%%%%%%%%%%%%%%%%  %%%%  %%
%%   %%%%%%%%%%%%%%%%   %%%   %%
%%   %%%%%%%%%%%%%%%%    %%%  %%
%%   %%%%%%%%%%%%%%%%%  %%%   %%
%%       %%%%%%%%%%%%% %%%%%  %%
%%      %%%%%%%%%%%%%  %%%%   %%
%%     %%%%%%%%%%%%%%   %%%   %%
%%    %%%%%%          %%%%    %%
%%   %%%%%%%          %%%%    %%
%%  %%%%%%%%%%%%%%%%% %%%%    %%
%%   %%%%%%%%%%%%%%%% %%%%    %%
%%   %%%%%%%%%%%%%%%%%%%%%%%%%%%
%%                 %%%  %%%%%%%%
%%                 %%%  %%%%%%%%
%%                 %%%  ...  %%%
%%                 %%%  ...  %%%
%%                 %%%  ...  %%%
%%                 %%%%%%%%%%%%%
%%                  %%%%%%%%%%%%
%%%%%%%%%%%%%%%%%%%%%%%%%%%%%%%%
%%%%%%%%%%%%%%%%%%%%%%%%%%%%%%%%
#
%%%%%%%%%%%%%%%%%%%%%%%%%%%%%%%%
%%%%%%%%%%%%%%%%%%%%%%%%%%%%%%%%
%%%%%%%%%%%%%%%%%%%%%%%%%%%%%%%%
% %%%%%%%%%%%%%%%%%%%%%%%      %
% %        %%%%%%%%%%%%%%      %
% %%%%%%%%%%%%%%%%%   %%%%     %
% %%%%%%%%%%%%%%%%%%   %%%     %
% %%%%%%%%%%%%%%%%%%   %%%     %
% %%%%%%%%%%%%%%%%%%%  %%%%    %
% %%%%%%%%%%%%%%%%%%%   %%%    %
%    %%%%%%%%%%%%%%%%   %%%    %
%    %%%%%%%%%%%%%%%%    %%    %
%    %%%%%%%%%%%%%%%%    %%    %
%    %%%%%%%%%%%%%%%%   %%%    %
%    %%%%%%%%%%%%%%%%  %%%%    %
%      %%%%%%%%%%%%%%  %%%%    %
%     %%%%%%%%%%%%%%%  %%%%    %
%    %%%%%%%%%%%%%%%%  %%%     %
%    %%%%%%%%%%%%%%%%  %%      %
%    %%%%%%%%%%%%%%%%  %%      %
%    %%%%%%%%%%%%%%%%  %%%%%%%%%
%    %%%%%%%%%%%%%%%%  %%%%%%%%%
%    %%%%%%%%%%%%%%%%  %%%%%%%%%
%                   %  %%%%%%%%%
%                   %  %%%%%%%%%
%                   %   ...   %%
%                   %%%%%%%%%%%%
%                   %%%%%%%%%%%%
%%%%%%%%%%%%%%%%%%%%%%%%%%%%%%%%
%%%%%%%%%%%%%%%%%%%%%%%%%%%%%%%%
%%%%%%%%%%%%%%%%%%%%%%%%%%%%%%%%
#
