%%%%%%%%%%%%%%%%%%%%%%%%%%%%%%%%%%%%%%%%%%%%%%%%%%%%%%%%%%%%%%%
%%%%%%%%%%%%%%%%%%%%%%%%%%%%%%%%%%%%%%%%%%%%%%%%%%%%%%%%%%%%%%%
%%%%%%%%%%%%%%%%%%%%%%%%%%%%                             %%%%%%
%%%%%%%%%%%%%%%%%%%%%%%%%%%%%%%%%%%%%%%%%%%%%%%%%%       %%%%%%
%%%%%%%%%%       %%%%%%%%%%%%%%%%%%%%%%%%%%%%%%%%%       %%%%%%
%%%%%%%%%%         %%%%%%%%%%%%%%%%%%%%%%%%%%%%%%%%      %%%%%%
%%%%%%%%%%                              %%%%%%%%%%%      %%%%%%
%%%%%%%%%%                              %%%%%%%%%%%      %%%%%%
%%%%%%%%%%                               %%%%%%%%%%%     %%%%%%
%%%%%%%%%%                               %%%%%%%%%%%     %%%%%%
%%%%%%%%%%         %%%%%%%%%%%%%%%%%%%%%  %%%%%%%%%%%    %%%%%%
%%%%%%%%%%        %%%%%%%%%%%%%%%%%%%%%%  %%%%%%%%%%%    %%%%%%
%%%%%%%%%%       %%%%%%%%%%%%%%%%%%%%%%%% %%%%%%%%%%%%   %%%%%%
%%%%%%%%%%%%%%%%%%%%%%%%%%%%  %%%%%%%%%%%  %%%%%%%%%%%   %%%%%%
%%%%%%%%%%%%%%%%%%%%%%%%%%%   %%%%%%%%%%%% %%%%%%%%%%%%  %%%%%%
%%%%%%%%%%%%%%%%%%%%%%%%%%     %%%%%%%%%%%  %%%%%%%%%%%  %%%%%%
%%%%%%                          %%%%%%%%%%% %%%%%%%%%%%  %%%%%%
%%%%%%                          %%%%%%%%%%%  %%%%%%%%%%% %%%%%%
%%%%%%                           %%%%%%%%%%% %%%%%%%%%%% %%%%%%
%%%%%%                           %%%%%%%%%%%% %%%%%%%%%%%%%%%%%
%%%%%%                            %%%%%%%%%%% %%%%%%%%%%%%%%%%%
%%%%%%%%%%%%%%%%%%%%%%%%%%%%%%%%%%%%%%%%%%%%%%%%%%%%%%%%%%%%%%%
%%%%%%%%%%%%%%%%%%%%%%%%%%%%%%%%%%%%%%%%%%%%%  %%%%%%%%%%%%%%%%
%%%%%%%%%%%%%%%%%%%%%%%%%%%%%%%%%%%%%%%%%%%%%% %%%%%%%%%%%%%%%%
%%%%%%%%%%%%%%%%%%%%%%%%%%%%%%%%%%%%%%%%%%%%%% %%%%%%%%%%%%%%%%
%%%%%%%%%%%%%%%%%%%%%%%%%%%%%%%%%%%%%%%%%%%%%% %%%%%%%%%%%%%%%%
%%%%%%                             %%%%%%%%%%%%%%%%%%%%%%%%%%%%
%%%%%%                             %%%%%%%%%%%%%%%%%%%%%%%%%%%%
%%%%%%                             %%%%%%%%%%%%%%%%%%%%%%%%%%%%
%%%%%%         %%%%%%%%%%%%%%%%%%%%%%%%%%%%%%%%%%%%%%%%% %%%%%%
%%%%%%        %%%%%%%%%%%%%%%%%%%%%%%%%%%%%%%%%%%%%%%%%  %%%%%%
%%%%%%       %%%%%%%%%%%%%%%%%%%%%%%%%%%%%%%%%%%%%%%%%   %%%%%%
%%%%%%      %%%%%%%%%%%%%%                %%%%%%%%%%%%   %%%%%%
%%%%%%     %%%%%%%%%%%%%%%                %%%%%%%%%%%    %%%%%%
%%%%%%    %%%%%%%%%%%%%%%%                %%%%%%%%%%%    %%%%%%
%%%%%%   %%%%%%%%%%%%%%%%%                %%%%%%%%%%%    %%%%%%
%%%%%%  %%%%%%%%%%%%%%%%%%                %%%%%%%%%%%    %%%%%%
%%%%%% %%%%%%%%%%%%%%%%%%%                %%%%%%%%%%%    %%%%%%
%%%%%%%%%%%%%%%%%%%%%%%%%%                %%%%%%%%%%%    %%%%%%
%%%%%%%%%%%%%%%%%%%%%%%%%%%%%%%%%%%%%%%%%%%%%%%%%%%%%    %%%%%%
%%%%%%%%%%%%%%%%%%%%%%%%%%%%%%%%%%%%%%%%%%%%%%%%%%%%%    %%%%%%
%%%%%%%%%%%%%%%%%%%%%%%%%%%%%%%%%%%%%%%%%%%%%%%%%%%%%    %%%%%%
%%%%%%                             %%%%%%%%%%%%%%%%%%    %%%%%%
%%%%%%                             %%%%%%%%%%%%%%%%%%%%%%%%%%%%
%%%%%%                             %%%%%%%%%%%%%%%%%%%%%%%%%%%%
%%%%%%                             %%%%%%%%%%%%%%%%%%%%%%%%%%%%
%%%%%%                             %%%%%%%%%%%         %%%%%%%%
%%%%%%                             %%%%%%%%%%%         %%%%%%%%
%%%%%%                             %%%%%%%%%%%.........%%%%%%%%
%%%%%%                             %%%%%%%%%%%.........%%%%%%%%
%%%%%%                             %%%%%%%%%%%.........%%%%%%%%
%%%%%%                             %%%%%%%%%%%.........%%%%%%%%
%%%%%%                             %%%%%%%%%%%.........%%%%%%%%
%%%%%%                             %%%%%%%%%%%         %%%%%%%%
%%%%%%                             %%%%%%%%%%%         %%%%%%%%
%%%%%%                             %%%%%%%%%%%%%%%%%%%%%%%%%%%%
%%%%%%                             %%%%%%%%%%%%%%%%%%%%%%%%%%%%
%%%%%%                             %%%%%%%%%%%%%%%%%%%%%%%%%%%%
%%%%%%                                                   %%%%%%
%%%%%%%%%%%%%%%%%%%%%%%%%%%%%%%%%%%%%%%%%%%%%%%%%%%%%%%%%%%%%%%
%%%%%%%%%%%%%%%%%%%%%%%%%%%%%%%%%%%%%%%%%%%%%%%%%%%%%%%%%%%%%%%
#
%%%%%%%%%%%%%%%%%%%%%%%%%%%%%%%%%%%%%%%%%%%%%%%%%%%%%%%%%%%%%%%
%%%%%%%%%%%%%%%%%%%%%%%%%%%%%%%%%%%%%%%%%%%%%%%%%%%%%%%%%%%%%%%
%%%%%%%%%%%%%%%%%%%%%%%%%%%%%%%%%%%%%%%%%%%%%%%%%%%%%%%%%%%%%%%
%%%%%%%%%%%%%%%%%%%%%%%%%%%%%%%%%%%%%%%%%%%%%%%%%%%%%%%%%%%%%%%
%%%%%%%%%%%%%%%%%%%%%%%%%%%%%%%%%%%%%%%%%%%%%%%%           %%%%
%%%%%%%%%%%%%%%%%%%%%%%%%%%%%%%%%%%%%%%%%%%%%%%%           %%%%
%%%%%%%%             %%%%%%%%%%%%%%%%%%%%%%%%%%%%          %%%%
%%%%%%%%                %%%%%%%%%%%%%%%%%%%%%%%%%          %%%%
%%%%%%%%P               %%%%%%%%%%%        %%%%%%%         %%%%
%%%%%%%%              % %%%%%%%%%%%        %%%%%%%         %%%%
%%%%%%%%            %%%%%%%%%%%%%%% %%      %%%%%%%        %%%%
%%%%%%%%%%%%%%%%%%%%%%%%%%%%%%%%%%%%%%      %%%%%%%        %%%%
%%%%%%%%%%%%%%%%%%%%%%%%%%%%%%%%%%%%%%%      %%%%%%%       %%%%
%%%%%%%%%%%%%%%%%%%%%%%%%%%%%%%%%%%%%%%      %%%%%%%       %%%%
%%%%%%%%%%%%%%%%%%%%%%%%%%%%%%%%%%%%%%%%     %%%%%%%       %%%%
%%%%%%%%%%%%%%%%%%%%%%%%%        %%%%%%%      %%%%%%%      %%%%
%%%%%%%%%%%%%%%%%%%%% %           %%%%%%%     %%%%%%%      %%%%
%%%%%%%%%%%%%%%%%%%%%             %%%%%%%      %%%%%%%     %%%%
%%%%                               %%%%%%%     %%%%%%%     %%%%
%%%%      %%%%%%%%%%%%%%%%%%%%%%%%%%%%%%%%%     %%%%%%%    %%%%
%%%%      %%%%%%%%%%%%%%%%%%%%%%%%%%%%%%%%%     %%%%%%%    %%%%
%%%%      %%%%%%%%%%%%%%%%%%%%%%%%%%%%%%%%       %%%%%%    %%%%
%%%%      %%%%%%%%%%%%%%%%%%%%%%%%%%%%%%%        %%%%      %%%%
%%%%   %%%%%%%%%%%%%%%%%%%%%%%%%%%%%%%%%%        %%%%%%%   %%%%
%%%%      %%%%%%%%%%%%%%%%%%%%%%%%%%%%%%%        %%%%%%%   %%%%
%%%%      %%%%%%%%%%%%%%%%%%%%%%%%%%%%%%%%%%     %%%%%%%   %%%%
%%%%      %%%%%%%%%%%%%%%%%%%%%%%%%%%%%%%%%%    %%%%%      %%%%
%%%%      %%%%%%%%%%%%%%%%%%%%%%%%%%%%%%%%%%   %%%%%%%     %%%%
%%%%              % %%%%%%%%%%%%%%%%%%%%%%%%   %%%%%%%%    %%%%
%%%%             %%%%%%%%%%%%%%%%%%%%%%%%%%%  %%%%%%%%     %%%%
%%%%            %%%%%%%%%%%%%%%%%%%%%%%%%    %%%%%%%%      %%%%
%%%%           %%%%%%%%%%%%%%%%%%%%%%%%%%     %%%%%%%      %%%%
%%%%          %%%%%%%%%%%%%%%%%%%%%%%%%%%      %%%%%       %%%%
%%%%         %%%%%%%%%%%%%%%%%%%%%%%%%%%%   %%%%%%%        %%%%
%%%%        %%%%%%%%%%%%                    %%%%%%%        %%%%
%%%%       %%%%%%%%%%%%%                    %%%%%%%        %%%%
%%%%      %%%%%%%%%%%%%%                    %%%%%%%        %%%%
%%%%     %%%%%%%%%%%%%%%%%%%%%%%%%%%%%%%%   %%%%%%%        %%%%
%%%%    %%%%%%%%%%%%%%%%%%%%%%%%%%%%%%%%%   %%%%%%%        %%%%
%%%%     %%%%%%%%%%%%%%%%%%%%%%%%%%%%%%%%   %%%%%%%        %%%%
%%%%      %%%%%%%%%%%%%%%%%%%%%%%%%%%%%%%   %%%%%%%        %%%%
%%%%      %%%%%%%%%%%%%%%%%%%%%%%%%%%%%%%%%%%%%%%%%%%%%%%%%%%%%
%%%%      %%%%%%%%%%%%%%%%%%%%%%%%%%%%%%%%%%%%%%%%%%%%%%%%%%%%%
%%%%      %%%%%%%%%%%%%%%%%%%%%%%%%%%%%%%%%%%%%%%%%%%%%%%%%%%%%
%%%%                                 %%%%%%%   %%%%%%%%%%%%%%%%
%%%%                                 %%%%%%%   %%%%%%%%%%%%%%%%
%%%%                                 %%%%%%%   %%%%%%%%%%%%%%%%
%%%%                                 %%%%%%%   %%%%%%%%%%%%%%%%
%%%%                                 %%%%%%%    .....    %%%%%%
%%%%                                 %%%%%%%   .......   %%%%%%
%%%%                                 %%%%%%%   .......   %%%%%%
%%%%                                 %%%%%%%   .......   %%%%%%
%%%%                                 %%%%%%%    .....    %%%%%%
%%%%                                 %%%%%%%%%%%%%%%%%%%%%%%%%%
%%%%                                 %%%%%%%%%%%%%%%%%%%%%%%%%%
%%%%                                 %%%%%%%%%%%%%%%%%%%%%%%%%%
%%%%                                    %%%%%%%%%%%%%%%%%%%%%%%
%%%%%%%%%%%%%%%%%%%%%%%%%%%%%%%%%%%%%%%%%%%%%%%%%%%%%%%%%%%%%%%
%%%%%%%%%%%%%%%%%%%%%%%%%%%%%%%%%%%%%%%%%%%%%%%%%%%%%%%%%%%%%%%
%%%%%%%%%%%%%%%%%%%%%%%%%%%%%%%%%%%%%%%%%%%%%%%%%%%%%%%%%%%%%%%
%%%%%%%%%%%%%%%%%%%%%%%%%%%%%%%%%%%%%%%%%%%%%%%%%%%%%%%%%%%%%%%
#
%%%%%%%%%%%%%%%%%%%%%%%%%%%%%%%%%%%%%%%%%%%%%%%%%%%%%%%%%%%%%%%
%%%%%%%%%%%%%%%%%%%%%%%%%%%%%%%%%%%%%%%%%%%%%%%%%%%%%%%%%%%%%%%
%%%%%%%%%%%%%%%%%%%%%%%%%%%%%%%%%%%%%%%%%%%%%%%%%%%%%%%%%%%%%%%
%%%%%%%%%%%%%%%%%%%%%%%%%%%%%%%%%%%%%%%%%%%%%%%%%%%%%%%%%%%%%%%
%%%%%%%%%%%%%%%%%%%%%%%%%%%%%%%%%%%%%%%%%%%%%%%%%%%%%%%%%%%%%%%
%%%%%%%%%%%%%%%%%%%%%%%%%%%%%%%%%%%%%%%%%%%%%%%%%%%%%%%%%%%%%%%
%% %%%%%%%%%%%%%%%%%%%%%%%%%%%%%%%%%%%%%%%%%%%%%%            %%
%% %%%%%%%%%%%%%%%%%%%%%%%%%%%%%%%%%%%%%%%%%%%%%%            %%
%% %%%               %%%%%%%%%%%%%%%%%%%%%%%%%%%%%           %%
%% %%%%%%%%%%%%%%%%%%%%%%%%%%%%%%%%%%%%%%%%%%%%%%%           %%
%% %%%%%%%%%%%%%%%%%%%%%%%%%%%%%%%%%%%      %%%%%%%          %%
%% %%%%%%%%%%%%%%%%%%%%%%%%%%%%%%%%%%%      %%%%%%%          %%
%% %%%%%%%%%%%%%%%%%%%%%%%%%%%%%%%%%%%%      %%%%%%          %%
%% %%%%%%%%%%%%%%%%%%%%%%%%%%%%%%%%%%%%      %%%%%%%         %%
%% %%%%%%%%%%%%%%%%%%%%%%%%%%%%%%%%%%%%%      %%%%%%         %%
%% %%%%%%%%%%%%%%%%%%%%%%%%%%%%%%%%%%%%%%     %%%%%%%        %%
%% %%%%%%%%%%%%%%%%%%%%%%%%%%%%%%%%%%%%%%     %%%%%%%        %%
%% %%%%%%%%%%%%%%%%%%%%%%%%%%%%%%%%%%%%%%%     %%%%%%%       %%
%% %%%%%%%%%%%%%%%%%%%%%%%%%%%%%%%%%%%%%%      %%%%%%%       %%
%% %%%%%%%%%%%%%%%%%%%%%%%%%%%%%%%%%%%%%%%      %%%%%%       %%
%%       %%%%%%%%%%%%%%%%%%%%%%%%%%%%%%%%%      %%%%%%       %%
%%       %%%%%%%%%%%%%%%%%%%%%%%%%%%%%%%%%       %%%%%       %%
%%       %%%%%%%%%%%%%%%%%%%%%%%%%%%%%%%%%       %%%%%       %%
%%       %%%%%%%%%%%%%%%%%%%%%%%%%%%%%%%%%        %%%%       %%
%%       %%%%%%%%%%%%%%%%%%%%%%%%%%%%%%%%%       %%%%%       %%
%%       %%%%%%%%%%%%%%%%%%%%%%%%%%%%%%%%%      %%%%%%       %%
%%       %%%%%%%%%%%%%%%%%%%%%%%%%%%%%%%%%     %%%%%%%       %%
%%       %%%%%%%%%%%%%%%%%%%%%%%%%%%%%%%%%    %%%%%%%%       %%
%%       %%%%%%%%%%%%%%%%%%%%%%%%%%%%%%%%%    %%%%%%%%       %%
%%       %%%%%%%%%%%%%%%%%%%%%%%%%%%%%%%%%    %%%%%%%%       %%
%%            %%%%%%%%%%%%%%%%%%%%%%%%%%%%    %%%%%%%%       %%
%%           %%%%%%%%%%%%%%%%%%%%%%%%%%%%%    %%%%%%%%       %%
%%          %%%%%%%%%%%%%%%%%%%%%%%%%%%%%%    %%%%%%%        %%
%%         %%%%%%%%%%%%%%%%%%%%%%%%%%%%%%%    %%%%%%         %%
%%        %%%%%%%%%%%%%%%%%%%%%%%%%%%%%%%%    %%%%%          %%
%%       %%%%%%%%%%%%%%%%%%%%%%%%%%%%%%%%%    %%%%           %%
%%        %%%%%%%%%%%%%%%%%%%%%%%%%%%%%%%%    %%%%           %%
%%        %%%%%%%%%%%%%%%%%%%%%%%%%%%%%%%%    %%%            %%
%%        %%%%%%%%%%%%%%%%%%%%%%%%%%%%%%%%    %%%            %%
%%        %%%%%%%%%%%%%%%%%%%%%%%%%%%%%%%%    %%%%%%%%%%%%%%%%%
%%        %%%%%%%%%%%%%%%%%%%%%%%%%%%%%%%%    %%%%%%%%%%%%%%%%%
%%        %%%%%%%%%%%%%%%%%%%%%%%%%%%%%%%%    %%%%%%%%%%%%%%%%%
%%        %%%%%%%%%%%%%%%%%%%%%%%%%%%%%%%%    %%%%%%%%%%%%%%%%%
%%        %%%%%%%%%%%%%%%%%%%%%%%%%%%%%%%%    %%%%%%%%%%%%%%%%%
%%        %%%%%%%%%%%%%%%%%%%%%%%%%%%%%%%%    %%%%%%%%%%%%%%%%%
%%       %%%%%%%%%%%%%%%%%%%%%%%%%%%%%%%%%    %%%%%%%%%%%%%%%%%
%%                                     %%%    %%%%%%%%%%%%%%%%%
%%                                     %%%    %%%%%%%%%%%%%%%%%
%%                                     %%%    %%%%%%%%%%%%%%%%%
%%                                     %%%    %%%%%%%%%%%%%%%%%
%%                                     %%%      .....      %%%%
%%                                     %%%%%%%%%%%%%%%%%%%%%%%%
%%                                     %%%%%%%%%%%%%%%%%%%%%%%%
%%                                     %%%%%%%%%%%%%%%%%%%%%%%%
%%                                     %%%%%%%%%%%%%%%%%%%%%%%%
%%%%%%%%%%%%%%%%%%%%%%%%%%%%%%%%%%%%%%%%%%%%%%%%%%%%%%%%%%%%%%%
%%%%%%%%%%%%%%%%%%%%%%%%%%%%%%%%%%%%%%%%%%%%%%%%%%%%%%%%%%%%%%%
%%%%%%%%%%%%%%%%%%%%%%%%%%%%%%%%%%%%%%%%%%%%%%%%%%%%%%%%%%%%%%%
%%%%%%%%%%%%%%%%%%%%%%%%%%%%%%%%%%%%%%%%%%%%%%%%%%%%%%%%%%%%%%%
%%%%%%%%%%%%%%%%%%%%%%%%%%%%%%%%%%%%%%%%%%%%%%%%%%%%%%%%%%%%%%%
%%%%%%%%%%%%%%%%%%%%%%%%%%%%%%%%%%%%%%%%%%%%%%%%%%%%%%%%%%%%%%%
#
