%%%%%%%%%%%%
%%%     %%%%
%%%     %%%%
%%%  ...%%%%
%%%  ...%%%%
%%%  ...%%%%
%%%     %%%%
%%%     %%%%
%%%%%%%%%%%%
#
%%%%%%%%%%%%
%%%%%%%%%%%%
%%%%%%%%%%%%
%%%P  ...%%%
%%%   ...%%%
%%%   ...%%%
%%%    ..%%%
%%%%%%%%%%%%
%%%%%%%%%%%%
#
%%%%%%%%%%%%
%%%%%%%%%%%%
%%%%%%%%%%%%
%      ...%%
%      ...%%
%      ...%%
%%%%%%%%%%%%
%%%%%%%%%%%%
%%%%%%%%%%%%
#
