%%%%%%%%%%%%%%%%%%%%%%%%%%%%%%%%%%%%%
%%%%%%%%%%%%%%                    %%%
%%%%%   %%%%%%%                   %%%
%%%%%    %%%%%%%%%%%%%%%%         %%%
%%%%%               %%%%%%        %%%
%%%%%                %%%%%        %%%
%%%%%     %%%%%%%%%% %%%%%%       %%%
%%%%%    %%%%%%%%%%%  %%%%%       %%%
%%%%%%%%%%%%%% %%%%%% %%%%%%      %%%
%%%           %%%%%%%  %%%%%      %%%
%%%      %%%%%%%%%%    %%%%%%     %%%
%%%  %%%%%%%%%%         %%%%%%%%%%%%%
%%%%%%%%%%%%%%%%%%%%%%%      ....%%%%
%%%               %%%%%%%%%%%%%%%%%%%
%%%               %%%%%%%%%%      %%%
%%%    %%%%%%%%%%%%%%%%%%%%%      %%%
%%%   %%%%%%%         %%%%%       %%%
%%%  %%%%%%%          %%%%%       %%%
%%% %%%%%%%           %%%%%       %%%
%%%%%%%%%%.           %%%%%       %%%
%%%%%%%%%%%%%%%%%%%%%%%%%%%       %%%
%%%               %%%%%%%%%       %%%
%%%               %%%%%%%%%%%%%%% %%%
%%%               %%%%%     %%%%% %%%
%%%               %%%%%.....%%%%% %%%
%%%               %%%%%.....%%%%% %%%
%%%               %%%%%%%%%%%%%%% %%%
%%%%%%%%%%%%%%%%%%%%%%%%%%%%%%%%%%%%%
#
%%%%%%%%%%%%%%%%%%%%%%%%%%%%%%%%%%%%%
%%%%%%%%%%%%%%%%%%%%%%%%%%%%%%%%%%%%%
%%%%%%%%%%%%%%%%%%%%%%%            %%
%%%%      %%%%%%%%%%%%%%%          %%
%%%%P      %%%%%%%%%%%%%%          %%
%%%%        %%%%%%   %%%%%         %%
%%%%      %%%%%%%%    %%%%         %%
%%%%%%%%%%%%%%%%%%%%  %%%%%        %%
%%%%%%%%%%%%%%%%%%%%   %%%%        %%
%%%%%%%%%%%%%%%%%%%    %%%%%       %%
%%   %%%%%%%%%%%%%%     %%%%%%%%%%%%%
%%   %%%%%%%%%%%%%%%%   %%%%%%%%%%%%%
%%   %%%%%%%%%%%%%%%%    %%%%%%%%%%%%
%%   %%%%%%%%%%%%%%%%% %%%%%%%%%%%%%%
%%       %%%%%%%%%%%%% %%%%%%%%%%%%%%
%%      %%%%%%%%%%%%%  %%%%        %%
%%     %%%%%%%%%%%%%%   %%%        %%
%%    %%%%%            %%%         %%
%%   %%%%%             %%%         %%
%%  %%%%%%%%%%%%%%%%%  %%%         %%
%%   %%%%%%%%%%%%%%%%  %%%         %%
%%   %%%%%%%%%%%%%%%%% %%%%%%%%    %%
%%                 %%%  %%%%%%%    %%
%%                 %%%  %%%%%%%%   %%
%%                 %%%  ...  %%%   %%
%%                 %%%%%%%%%%%%%   %%
%%%%%%%%%%%%%%%%%%%%%%%%%%%%%%%%%%%%%
%%%%%%%%%%%%%%%%%%%%%%%%%%%%%%%%%%%%%
#
%%%%%%%%%%%%%%%%%%%%%%%%%%%%%%%%%%%%%
%%%%%%%%%%%%%%%%%%%%%%%%%%%%%%%%%%%%%
%%%%%%%%%%%%%%%%%%%%%%%%%%%%%%%%%%%%%
% %%%%%%%%%%%%%%%%%%%%%%            %
% %       %%%%%%%%%%%%%%%           %
% %        %%%%%%%%%%%%%%           %
% %%%%%%%%%%%%%%%%%   %%%%          %
% %%%%%%%%%%%%%%%%%    %%%          %
% %%%%%%%%%%%%%%%%%    %%%%         %
% %%%%%%%%%%%%%%%%%     %%%%%%%%%%%%%
% %%%%%%%%%%%%%%%%%%%   %%%%%%%%%%%%%
%    %%%%%%%%%%%%%%%%    %%%%%%%%%%%%
%    %%%%%%%%%%%%%%%%   %%%%%%%%%%%%%
%    %%%%%%%%%%%%%%%%   %%%%%%%%%%%%%
%    %%%%%%%%%%%%%%%%   %%%%%%%%%%%%%
%      %%%%%%%%%%%%%%   %%%%%%%%%%%%%
%     %%%%%%%%%%%%%%%   %%          %
%    %%%%%%%%%%%%%%%%   %%          %
%    %%%%%%%%%%%%%%%%   %           %
%    %%%%%%%%%%%%%%%%   %           %
%    %%%%%%%%%%%%%%%%   %%%%%%%     %
%    %%%%%%%%%%%%%%%%   %%%%%%%     %
%    %%%%%%%%%%%%%%%%   %%%%%%%     %
%                   %   %%%%%%%     %
%                   %%%%%%%%%%%     %
%%%%%%%%%%%%%%%%%%%%%%%%%%%%%%%%%%%%%
%%%%%%%%%%%%%%%%%%%%%%%%%%%%%%%%%%%%%
%%%%%%%%%%%%%%%%%%%%%%%%%%%%%%%%%%%%%
#
