%%%%%%%%%%%%%%%%%%%%%%%%%%%%%%%%%%%%%
%%%%%%%%%%%%%%%%%%%%%%%%%%%%%%%%%%%%%
%%%%%%%%%%%%%%%%%%%%%%%%%        %%%%
%%%%%%   %%%%%%%%%%%%%%%%        %%%%
%%%%%%    %%%%%%%%%%%%%%%%       %%%%
%%%%%%               %%%%%       %%%%
%%%%%%    %%%%%%%%%% %%%%%%      %%%%
%%%%%%%%%%%%%%%%%%%%  %%%%%      %%%%
%%%%%%%%%%%%%% %%%%%% %%%%%%     %%%%
%%%%%%%%%%%%% %%%%%%%  %%%%%     %%%%
%%%%     %%%%%%%%%%    %%%%%%%%%%%%%%
%%%%%%%%%%%%%%%%%%%%%%% %%%%%%%%%%%%%
%%%%%%%%%%%%%%%%%%%%%%%%%%%%%%%%%%%%%
%%%%%%%%%%%%%%%%%%%%%%%%%%%%%%%%%%%%%
%%%%    %%%%%%%%%%%%%%%%%%%%%%%%%%%%%
%%%%   %%%%%%%%%%%%%%%%%%%%%     %%%%
%%%%  %%%%%%%%%%%%%%%%%%%%%%     %%%%
%%%% %%%%%%%         %%%%%%%     %%%%
%%%%%%%%%%%          %%%%%%%     %%%%
%%%%%%%%%%%%%%%%%%%%%%%%%%%%     %%%%
%%%%%%%%%%%%%%%%%%%%%%%%%%%%     %%%%
%%%%%%%%%%%%%%%%%%%%%%%%%%%%%%%%%%%%%
%%%%             %%%%%%%%%%%%%%%%%%%%
%%%%             %%%%%%%%%%%%%%%%%%%%
%%%%             %%%%%%%...%%%%%%%%%%
%%%%             %%%%%%%%%%%%%%%%%%%%
%%%%%%%%%%%%%%%%%%%%%%%%%%%%%%%%%%%%%
%%%%%%%%%%%%%%%%%%%%%%%%%%%%%%%%%%%%%
#
%%%%%%%%%%%%%%%%%%%%%%%%%%%%%%%%%%%%%
%%%%%%%%%%%%%%%%%%%%%%%%%%%%%%%%%%%%%
%%%%%%%%%%%%%%%%%%%%%%%            %%
%%%%      %%%%%%%%%%%%%%%          %%
%%%%P      %%%%%%%%%%%%%%          %%
%%%%        %%%%%%   %%%%%         %%
%%%%      %%%%%%%%    %%%%         %%
%%%%%%%%%%%%%%%%%%%%  %%%%%        %%
%%%%%%%%%%%%%%%%%%%%   %%%%        %%
%%%%%%%%%%%%%%%%%%%    %%%%%       %%
%%   %%%%%%%%%%%%%%     %%%%%%%%%%%%%
%%   %%%%%%%%%%%%%%%%   %%%%%%%%%%%%%
%%   %%%%%%%%%%%%%%%%    %%%%%%%%%%%%
%%   %%%%%%%%%%%%%%%%% %%%%%%%%%%%%%%
%%       %%%%%%%%%%%%% %%%%%%%%%%%%%%
%%      %%%%%%%%%%%%%  %%%%        %%
%%     %%%%%%%%%%%%%%   %%%        %%
%%    %%%%%            %%%         %%
%%   %%%%%             %%%         %%
%%  %%%%%%%%%%%%%%%%%  %%%         %%
%%   %%%%%%%%%%%%%%%%  %%%         %%
%%   %%%%%%%%%%%%%%%%% %%%%%%%%    %%
%%                 %%%  %%%%%%%    %%
%%                 %%%  %%%%%%%%   %%
%%                 %%%  ...  %%%   %%
%%                 %%%%%%%%%%%%%   %%
%%%%%%%%%%%%%%%%%%%%%%%%%%%%%%%%%%%%%
%%%%%%%%%%%%%%%%%%%%%%%%%%%%%%%%%%%%%
#
%%%%%%%%%%%%%%%%%%%%%%%%%%%%%%%%%%%%%
%%%%%%%%%%%%%%%%%%%%%%%%%%%%%%%%%%%%%
%%%%%%%%%%%%%%%%%%%%%%%%%%%%%%%%%%%%%
%%%%%%%%%%%%%%%%%%%%%%%%%%%%%%%%%%%%%
%%%%%%%%%%%%%%%%%%%%%%%%%          %%
%%%%%%%%%%%%%%%%%%%%%%%%%          %%
%%%%%%%%%%%%%%%%%%%%%%%%%%         %%
%%%%%%%%%%%%%%%%%%%    %%%         %%
%%%%%%%%%%%%%%%%%%%    %%%%%%%%%%%%%%
%%%%%%%%%%%%%%%%%%%%%   %%%%%%%%%%%%%
%%%%%%%%%%%%%%%%%%%%%%  %%%%%%%%%%%%%
%%%%%%%%%%%%%%%%%%%%%%   %%%%%%%%%%%%
%%   %%%%%%%%%%%%%%%%%  %%%%%%%%%%%%%
%%   %%%%%%%%%%%%%%%%%  %%%%%%%%%%%%%
%%   %%%%%%%%%%%%%%%%% %%%%%%%%%%%%%%
%%   %%%%%%%%%%%%%%%%% %%%%%%%%%%%%%%
%%    %%%%%%%%%%%%%%%% %%%%%%%%%%%%%%
%%   %%%%%%%%%%%%%%%%% %%%         %%
%%   %%%%%%%%%%%%%%%%% %%%         %%
%%   %%%%%%%%%%%%%%%%% %%%%%%%%    %%
%%   %%%%%%%%%%%%%%%%% %%%%%%%%%   %%
%%   %%%%%%%%%%%%%%%%% %%%%%%%%%   %%
%%   %%%%%%%%%%%%%%%%% %%%%%%%%%   %%
%%   %%%%%%%%%%%%%%%%%%%%%%%%%%%   %%
%%%%%%%%%%%%%%%%%%%%%%%%%%%%%%%%%%%%%
%%%%%%%%%%%%%%%%%%%%%%%%%%%%%%%%%%%%%
%%%%%%%%%%%%%%%%%%%%%%%%%%%%%%%%%%%%%
%%%%%%%%%%%%%%%%%%%%%%%%%%%%%%%%%%%%%
#
