%%%%%%%%%%%%%%%%%%%%%%%
%%%%%%%%%%%%%%%%%%%%%%%
%%%%%%         %%%%%%%%
%%%%%%         %%%%%%%%
%%%%%%         %%%%%%%%
%%%%%%     ....%%%%%%%%
%%%%%%    .....%%%%%%%%
%%%%%%   ......%%%%%%%%
%%%%%%   ......%%%%%%%%
%%%%%%   ......%%%%%%%%
%%%%%%    .....%%%%%%%%
%%%%%%     ....%%%%%%%%
%%%%%%         %%%%%%%%
%%%%%%         %%%%%%%%
%%%%%%         %%%%%%%%
%%%%%%%%%%%%%%%%%%%%%%%
%%%%%%%%%%%%%%%%%%%%%%%
%%%%%%%%%%%%%%%%%%%%%%%
#
%%%%%%%%%%%%%%%%%%%%%%%
%%%%%%%%%%%%%%%%%%%%%%%
%%%%%%%%%%%%%%%%%%%%%%%
%%%%%%%%%%%%%%%%%%%%%%%
%%%%          ...%%%%%%
%%%%         ....%%%%%%
%%%%  P     .....%%%%%%
%%%%        .....%%%%%%
%%%%        .....%%%%%%
%%%%        .....%%%%%%
%%%%        .....%%%%%%
%%%%         ....%%%%%%
%%%%          ...%%%%%%
%%%%%%%%%%%%%%%%%%%%%%%
%%%%%%%%%%%%%%%%%%%%%%%
%%%%%%%%%%%%%%%%%%%%%%%
%%%%%%%%%%%%%%%%%%%%%%%
%%%%%%%%%%%%%%%%%%%%%%%
#
%%%%%%%%%%%%%%%%%%%%%%%
%%%%%%%%%%%%%%%%%%%%%%%
%%%%%%%%%%%%%%%%%%%%%%%
%%%%%%%%%%%%%%%%%%%%%%%
%%%%%%%%%%%%%%%%%%%%%%%
%%%%%%%%%%%%%%%%%%%%%%%
%%           ......%%%%
%%           ......%%%%
%%           ......%%%%
%%           ......%%%%
%%           ......%%%%
%%%%%%%%%%%%%%%%%%%%%%%
%%%%%%%%%%%%%%%%%%%%%%%
%%%%%%%%%%%%%%%%%%%%%%%
%%%%%%%%%%%%%%%%%%%%%%%
%%%%%%%%%%%%%%%%%%%%%%%
%%%%%%%%%%%%%%%%%%%%%%%
%%%%%%%%%%%%%%%%%%%%%%%
#
