%%%%%%%%%%%%%%%%%%%%%%%
%%%         %%%%%%%%%%%
%%%    %%%%%%%%%%  %%%%
%%%    %%%%%%%%%   %%%%
%%%    %%%%%...    %%%%
%%%    %%%%%%%%%   %%%%
%%%    %%%%%%%%%%  %%%%
%%%         %%%%%%%%%%%
%%%           %%%%%%%%%
%%%%%%%%%%%%%%%%%%%%%%%
%%%      %%%%%%%%% %%%%
%%%                %%%%
%%%                %%%%
%%%                %%%%
%%%       %%%%%%%%%%%%%
%%%%%%%%%%%%%%%     %%%
%%%                 %%%
%%%                 %%%
%%%                 %%%
%%%                 %%%
%%%%%%%%%%%%%%%%%%%%%%%
#
%%%%%%%%%%%%%%%%%%%%%%%
%%%%%%%%%%%%%%%%%%%%%%%
%%       %%%%%%%%%%%%%%
%%      %%%%%%%%    %%%
%%      %%%%%%      %%%
%%      %%%%%%%%    %%%
%%       %%%%%%%%%  %%%
%%       %%%%%%%%%  %%%
%%%%%%%%%%%%% %%%%% %%%
%%%%%%%%%%%%%%%%%%% %%%
%%%%%%%%%%%%%%%%%%  %%%
%%        %%%% %%   %%%
%% P         %      %%%
%%        %%%%%%%%%%%%%
%%%%%%%%%%%%%%%%%%%%%%%
%%%%%%%%%%%%%%%%%%%%%%%
%%%%%%%%%%%%%%%      %%
%%                   %%
%%                   %%
%%%%%%%%%%%%%%%%%%%%%%%
%%%%%%%%%%%%%%%%%%%%%%%
#
%%%%%%%%%%%%%%%%%%%%%%%
%%%%%%%%%%%%%%%%%%%%%%%
%%%%%%%%%%%%%%%%%%%%%%%
%        %%%%%%%%%%%%%%
%        %%%%%%      %%
%        %%%%%%%%%   %%
%        %%%%%%%%%   %%
%%%%%%%%%%%%%%%%%%   %%
%%%%%%%%%%%%%%%%%%   %%
%%%%%%%%%%%%%%%%%%   %%
%%%%%%%%%%%%%%%%%%   %%
%%%%%%%%%%%%%%%%%    %%
%          %%%%%%%%%%%%
%%%%%%%%%%%%%%%%%%%%%%%
%%%%%%%%%%%%%%%%%%%%%%%
%%%%%%%%%%%%%%%%%%%%%%%
%%%%%%%%%%%%%%%%%%%%%%%
%%%%%%%%%%%%%         %
%%%%%%%%%%%%%%%%%%%%%%%
%%%%%%%%%%%%%%%%%%%%%%%
%%%%%%%%%%%%%%%%%%%%%%%
#
